 # # ### B
 # #   # #
 # # #   #
   # # ## 
# ## # ## 
#    # ## 
### ##    
A   ##    