# ####
#    #
# #B##
# # ##
#   ##
A ####